ccheremi CC H E R E M I
ggaan GG AA N
thappe TH A P E
han H A N
thuman TH U M A N
nembu N E M B U
gaganum G A G A N U M
bulle B U LL E
ka K A
tik T I K
germany J A R M A N I
ule U L E
ulle U LL E
hamesha H A M E SH A
siyama S I A M A
nachaar N A CH AA R
parhai P A R H A I
parhaai P A R H AA I
akkhatena A KKH A T E N A
har H A R
maatto M AA TT O
naqaabel N A Q AA B E L
chhap CHH A P
jawayu J A W A I U
echam E CH A M
khakarumam KH A K A R U M A N
khakkarumam KH A K A R U M A N
halle H A LL E
cxoqa CX O Q A
gutey G U T E 
gute G U T E 
gari G A R I
atumbu A T U M B U
etumbu E T U M B U
ve V E
tai T A I
muchar M U CHH A R
nae N AE
hir H I R
duwallasccemen D U W A LL AA S CC E M E N
hepullhtuk H E P U LL H T U K
bika B I K A
girminchumbai G I R M I N CH U M B A I
shumsher SH U M SH E R
momogga M O M O GG A
gomoos G O M OO S
gucxattinga G U CX A TT I N G A
saf S A F
shum SH U M
baspur B A S P U R
saegga S AE GG A
dost D O S T
gilhta G I L H T A
achumba A CH U M B A
gali G A L I
yatte Y A TT E
darhkut D A R H K U T
ms M S
guwanumba G U W A N U M B A
ayi A I
kattar K A TT A R
an A N
guwarumba G U W A R U M B A
ga G A
muhlchi M U H L CH I
akhunng AKH U N G
atumba A T U M B A
teytte T E Y A TT E
acce A CC E
apu A P U
amanamba A M A N A M B A
nnyu N Y U 
rai R A I
yanaa Y A N AA
shukuru SH U K U R U
baring	B A R I N G
bathanan	B A TH A N A N
amamaning	A M A M A N I N G
akhuyng	A KH U I N G
walimi	W A L I M I
waw	W A W
shuaa	SH U AA
sham	SH A M
huecxa	H U E CX A
hek	H E K
karachi	K A R A CH I
akhuing	A KH U I N G
ba	B A
xakune	X A K U N E
dumuch	D U M U CC
tthuko	TTH U K O
khatta	KH A TT A
bai	B A I
masqara	M A S Q A R A
besaa	B E S AA
haalle	H A A LL E
ballhas	B A LL H A S
nesxh	N E SXH
shua	SH U A
neme	N E M E
awaramba	A W A R A M B A
api	A P I
filhal	F I L A LL
butt	B U TT
tata	T A T A
gaaning	G A A N I N G
shakar	SH A K A R
khosh	KH O SH
kkhabar	KKH A B A R
usxhe	U SXH E
noyu	N O Y U
maya	M A Y A
gulabi	G U L A B I
shei	SH E I
doggoiki	D O GG O I K I
cxhew	CXH E W
thosxh	TH O SXH
llayen	LL E N
jua	J U A
ayideemi	A I I D E E M I
men	M E N
manunduaa	M A N U N D U AA
etaas	E T A AA S
nee	N E E
ge	G E
ccheremu	CCH E R E M U
yaarbullhtuk	Y AA R B U LL H T U K
mene	M E N E
guwaya	G U W A I A
hen	H E N
isxhqam	I SXH Q A M
biya	B I A
ccandurare	CC A N D U R A R E
seembayi	S E E M B A I I
nukkha	N U KKH A
kaatt	K AA TT
maza	M A Z A
hawaazan	H A W AA Z A N
berozgaar	B E R O Z G AA R
guya	G U Y A
yara	Y A R A
mes	M E S
dova	D U V A
thape	TH A P E
buddu	B U DD U
muwallumbu	M U W A LL U M B U
cchurimi	CC H U R I M I
paqo	P A Q O
mayimi	M A I I M I
haranga	H A R A N G A
nete	N E T E
shahar	SH A H A R
ghasxhap	G A SXH A P
taene	T AE N E
awuyi	A W U I
washchemen	W A SH CH E M E N
akhollum	A KH O LL U M
jagga	J A GG A
khatt	KH A TT
apaan	A P AA N
senas	S E N A S
washimi	W A SH I M I
atumbi	A T U M B I
shaghetan	SH A G H E T A N
wawen	W A W E N
washchumaan	W A SH CH U M AA N
un	U N
khai	KH A I
doro	D O R O
os	O S
amota	A M O T A
dicca	D I CC A
churumu	CHH U R U M U
yatta	Y A TT A
mull	M U LL
echamba	E CH A M B A
cchuwa	CCH U W A
dalla	D A LL A
mi	M I
chay	CH A I
cchandurare	CCH A N D U R A R E
etumbu	E T U M B U
ekhara	E KH A R A
washiaasccemen	W A S H I AA S CC E M E N
gadaero	G A D A E R O
diya	D I A
da	D A
ayechumbai	A I E CH U M B A I
acxo	A CX O
ttir	TT I R
negga	N E GG A
paisa	P A I S A
khasxh	KH A S CX
duwalimi	D U W A LL I M I
yanumba	Y A N U M B A
adite	A D I T E
acho	A CH O
muallumbu	M U A LL U M B U
do	D O
duchua	D U CHH U A
akhosh	A SH
tuni	T U N I
hallaes	H A LL AE S
nithi	N I T H I
kaman	K A M A N
shechumbi	SH E CH U M B I
jan	J A N
dunia	D U N I A
wallhte	W A LL H T E
baqi	B A Q I
ggaan	GG AA N
domo	D O M O
naegga	N AE GG A
agar	A G A R
saattik	S AA TT I K
vae	V A E
kyaki	K I A K I
girinj	G I R I N J
tausa	T A U S A
duchuwa	D U CHH U W A
miyamba	M I A M B A
ishpit	I SH P I T
yaara	Y AA R A
kam	K A M
berum	B E R U M
halles	H A LL E S
atumu	A T U M U
ajo	A J O
aye	A I E
washi	W A S H I
holla	H O LL A
hola	H O L A
kollo	K O LL O
dapherhkan	D A P H E R H K A N
tauruma	T A U R U M A
naeccum	N AE CC U M
chaggorum	CHH A GG O R U M
wali	W A L I
xoaas	X O AA S
simba	S I M B A
adit	A D I T
gosera	G O S E R A
guliab	G U L I A B
sxheli	SXH E L I
mogha	M O GG A
bess	B E S
hun	H U N
jaacce	J AA CC E
niyaa	N I A A
maato	M AA T O
gute	G U T E
jimall	J I M A LL
alag	A L A G
photo	PH O TT O
dallum	D A LL U M
asxhe	A SXH E
gogga	G O GG A
giraashumbai	G I R AA SH U M B A I
khene	KH E N E
hazir	H A Z I R
in	I N
berespate	B E R E S P A T E
cxoqaa	CX O Q AA
bokhabar	B O KH A B A R
neingea	N E I N G E A
chape	CHH A P E
akhilchu	A KH I L CH U
bisaarchen	B I S AA R CH E N
mobile	M OO B I L E
hal	H A L
netey	N E T E
yasena	Y A S E N A
nemi	N E M I
walchimi	W A L H CH I M I
internship	I N T E R N SH I P
nuvell	N U V E L L
muwashimbu	M U W A S H I M B U
lip	L I P
vaegga	V AE GG A
gamburimo	G A M B U R I M O
go	G O
deembi	D E E M B I
duwali	D U W A L I
guaacxa	G U AA CX A
nekaatt	N E K AA TT
hoi	H O I
gallu	G A LL U
qabel	Q A B E L
lala	L A L A
sattik	S A TT I K
yate	Y A T E
ley	L E
cxicxigha	CX I CX I G A
duam	D U A M
nuharya	N U A R I A
della	D E LL A
ayash	A I A SH
sahi	S A H I
guana	G U A N A
qaq	Q A Q
office	O F I S
duwalchumu	D U W A L CH U M U
phat	F A T
ccheram	CC H E R A M
hollum	H O LL U M
fis	F I S
noko	N O K O
cchella	CC H E LL A
bo	B O
preshaani	P A R E SH A A N I
jawaane	J A W AA N E
mogga	M O GG A
senumbu	S E N U M B U
she	SH E
yah	Y A
cheraagga	CCH E R AA GG A
domombuasccumu	D O M O M B U AA S CC U M U
nima	N I M A
eta	E T A
duwalchimi	D U W A L H CH I M I
chasxha	CHH A SXH A
khaasxh	KH AA SXH
filhaal	F I L AA LL
senumam	S E N U M A N
gon	G O N
na	N A
kaat	K AA T
not	N O T
dall	D A LL
lekin	L E K I N
wagera	W A G E R A
tunichi	T U N I CH I
echumbai	E CH U M B A I
isxhqa	I SXH Q A
duwalchemen	D U W A L CH E M E N
ccheraan	CCH E R AA N
echa	E CH A
domombu	D O M O M B U
qow	Q O W
manisxh	M A N I SXH
wallumbi	W A LL U M B I
duva	D U V A
chacha	CH A CH A
ne	N E
mel	M E L
zalim	Z A L I M
javaayu	J A V A A I U
nicchu	N I CCH U
bicca	B I CC A
bam	B A M
sam	S A M
bae	B AE
lay	L A I
uyi	U I
cchurumu	CC H U R U M U
seni	S E N I
numuwash	N U M U W A SH
bumbarak	B U M B A R A K
nomot	N O M O T
message	M E S A G E
washimaan	W A S H I M AA N
angaro	A N G A R O
ducchumu	D U CCH U M U
botan	B O T A N
wawe	W A W E
dang	D A N G
fanng	F A NG
docc	D O CC
hawaazing	H A W AA Z I N G
akhi	A KH I
tasveeran	T A S V E E R A N
bulyainge	B U L I A N G E
momo	M O M O
nume	N U M E
xo	X O
jaggachi	J A GG A CH I
meti	M E T I
guke	G U K E
ane	A N E
ita	I T A
cchor	CCH O R
xonng	X O NG
tournament	T O U R N A M E N T
momese	M O M E S E
etumbi	E T U M B I
amana	A M A N A
nemu	N E M U
baa	B A A
le	L E
hiren	H I R E N
etamam	E T A M A N
gosulle	G O S U LL E
depherhkan	D E PH E R H K A N
baraan	B A R AA N
ma	M A
duaa	D U AA
zehn	Z E H N
ucxhan	U CXH A N
dia	D I A
shaaski	SH AA S K I
ccheren	CCH E R E N
akhuly	A KH U L E
cardboard	C A R D B O A R D
news	N E W S
gamburi	G A M B U R I
ekharinga	E KH A R I N G A
esarcham	E S A R CH A M
xarurat	X A R U R A T
gudellumam	G U D E LL U M A N
ya	Y A
nisxhi	N I SXH I
naa	N AA
akuwayumba	A K U W A I U M B A
jaa	J AA
taap	T A A P
cchurumba	CCH U R U M B A
shaam	SH A A M
neh	N E
tati	T A T I
thum	TH U M
pettek	PH E TT E K
nupisha	N U P I SH A
net	N E T
gandi	G A N D I
shumshere	SH U M SH E R E
bull	B U LL
behell	B E H E LL
mukaatt M U K AA TT
e	E
dunesh	D U N E SH
duus	D U U S
nembai	N E M B A I
duwalhchimi	D U W A L CH I M I
maa	M AA
reporter	R E P O R T E R
addite	A D D I T E
anum	A N U M
ddoro	DD O R O
ggaring	GG A R I N G
numuma	N U M U M A
deembai	D E E M B A I
jirmani	J I R M A N I
dis	D I S
docca	D O CC A
daa	D A A
acxhan	A CXH A N
tayillhcc	T A I I LL H CC
biyenum	B I E N U M
momes	M O M E S
gukhar	G U KH A R
guwayumba	G U W A I U M B A
muyi	M U I
gunz	G U N Z
amuwa	A M U W A
guse	G U S E
hallesen	H A LL E S E N
nomo	N O M O
balhas	B A LL HA S
atimi	A T I M I
bullhtuki	B U LL H T U K I
cxham	CXH A M
theek	TH E E K
ho	H O
omoos	O M OO S
mall	M A LL
thamene	TH A M E N E
durdana	D U R D A N A
nembi	N E M B I
mo	M O
senumu	S E N U M U
senaa	S E N A A
xosxh	X O SXH
qauv	Q A U V
dell	D E LL
nuqas	N U Q A S
bi	B I
bota	B O T A
nega	N E G A
shaama	SH A A M A
dohon	D O H O N
hainn	H A I N
nembiasccimi	N E M B I AA S CC I M I
jagganng	J A GG A NG
tainge	T A I NG E
basha	B A SH A
musxhe	M U SXH E
boka	B O K A
dee	D E E
yaar	Y AA R
muwa	M U W A
sxhicxam	SXH I CX A M
ggafa	GG A f A
lloll	LL O LL
dua	D U A
ames	A M E S
fas	F A S
gattunz	G A TT U N Z
yarbullhtuk	Y A R B U LL H T U K
alchine	A L H CH I N E
laga	L A G A
xakun	X A K U N
nawall	N A W A LL
guccharchumbai	G U CCH A R CH U M B A I
senen	S E N E N
gatt	G A TT
duwalhchemen	D U W A L CH E M E N
thoro	TH O R O
sxhe	SXH E
niya	N I A
diyashchan	D I A SH CH A N
be	B E
jeet	J E E T
domoomu	D O M O O M U
deemi	D E E M I
xapaxap	X A P A X A P
khenae	KH E N AE
busy	B I Z I
mani	M A N I
behltum	B E L H T U M
tegga	T E GG A
wal	W A L
et	E T
neyamam	N E Y A M A M
tthukoga	TTH U K O G A
guhlltaing	G U LL H T A I N G
duccaa	D U CC AA
girminaas	G I R M I N AA S
nyu	N I U
bayi	B A I I
uwa	U W A
sheng	SH E N G
pindi	P I N D I
gga	GG A
awa	A W A
ayar	A I A R
aemeni	AE M E N I
showa	SH O W A
tunn	T U N
neaasccumu	N E AA S CC U M U
khita	KH I T A
ayuwa	A I U W A
ayet	A I E T
akKher	A KKH E R
bim	B I M
washiaasccimi	W A S H I AA S CC I M I
dan	D A N
warcca	W A R CC A
khaella	KH A E LL A
chamarutto	CH A M A R U TT O
daaya	D A A I A
library	L I B R A R I
cxhena	CXH E N A
ulle	U LL E
chakaatto	CH A K AA TT O
gucham	G U CH A M
chachaa	CH A CH AA
shohllty	SH O LL T E
saan	S AA N
yakalla	Y A K A LL A
pareshan	P A R E SH A N
baran	B A R A N
horgo	H O R G O
cchuren	CCH U R E N
yahlltare	Y A H LL T A R E
mucxhan	M U CX A N
contact	K O N T A K T
te	T E
cce	CC E
bahllt	B A H LL T
domoster	D O M O S T E R
akkhosh	A KKH O SH
ata	A T A
walhchimi	W A L H CH I M I
qaw	Q A W
besa	B E S A
tollum	T O LL U M
dokoosuljaas	D O K OO S U L J AA S
se	S E
ja	J A
thathall	TH A TH A LL
garuum	G A R UU M
segga	S E GG A
neingya	N E I N G I A
etas	E T A S
sayila	S A I I L A
dunya	D U N I A
mayundua	M A I U N D U A
gosqayamba	G O S Q A I A M B A
nigi	N I G I
manumbi	M A N U M B I
penan	P E N A N
ccheran	CC H E R A N
bahna	B A H N A
mishaaski	M I SH AA S K I
nuwell	N U W E LL
tunicha	T U N I CH A
amutuk	A M U T U K
nana	N A N A
yary	Y A R I
llayuman	LL A I U M A N
cchell	CC H E LL
cchel	CC H E L
